WE ./imgs/wall_W.png


EA ./imgs/wall_E.png
NO ./imgs/wall_N.png

F 100,200,1
SO ./imgs/wall_S.png

C  0,180,255


1111111111111111111111111111111111111111111111
1000000000000000000000000000000000000000000001
1000000000000000000000000000000000000000000001
1000000001100001100000001111111111100000000001
1000000001100001100000000000000001100000000001
1000000001100001100000000000000001100000000001
1000000001100001100000001111111111100000000001
1000000001100001100000001100000000000000000001
1000000001100001100000001100000000000000000001
1000000000111111100000001111111111100000000001
1000000000011111100000000000000000000000000001
1000000000000001100000000000000000000000000001
1000000000000001100000000000000000000000000001
1000E00000000001100000000000000000000000000001
1000000000000001100000000000000000000000000001
1000000000000001100000000000000000000000000001
1000000000000001100000000000000000000000000001
1000000000000000000000000000000000000000000001
1000000000Z00000000000000000000000000000000001
1000000000000000000000000000000000000000000001
1000000000000000000000000000000000000000000001
1000000000000000000000000000000000000000000001
1000000000000000000000000000000000000000000001
1111111111111111111111111111111111111111111111