W ./imgs/wall_N.png
E ./imgs/wall_S.png
N ./imgs/wall_W.png
S ./imgs/wall_E.png

F 44,44,44



C 44,44,44

11111111111111111111111111111111111111111
1111111000111110B01V1B1BBV110000000000001
100000111110000010B000009Z0B1110000000001
1E0000D000D00001B010000000G00GV1110000001
10000011111100111BBV1B11BGGB00GGVB1000001
1111111111111111111111111D11B000G0B110001
1001GGGGG1000001B1000001GG1011BGG000B1001
11D1GGGGGG10001GGG10001GGG100011B0Z1ZB101
1GGGGGGGGGG101GGBGG101GGG11000001BVBB1101
1GGZGGGGGGGG1GGG1GGG1GGG10100011111111101
1Z1GGG1111GGGGG111GGGGG10010111VGGGGG1001
111D1111111111111111111111V111VZ0GGGVV101
1000G0VVB1100G00V9000GVGBBGB110001VVG1001
1000000VB900000VB1000V111111G9000G1GBB101
1G00G0V111B100G0V9000GVGBGBBB1100GG1BGB11
1111111111D111111111111111111111111111D11
10000001000001000000000000000Z10000000001
10000001000001000000Z10Z10000000000000001
10000001111111000000000000Z10000000000001
100000000000000000Z1000000000000000000001
100000000010000000000Z10000Z1000000000001
1000000A00000000Z100000000000000000000001
10000Z10000000100000000010000000000000001
10000000000000000001000000000000000000001
10000000001000000000000000001000000000001
11111111111111111111111111111111111111111
