1111111111111111111111111111111111
1E1000000000000C00000C000000000001
1010010100100000101001000000010101
1C10010010101010001001000000010111
1P0000000C00C000000000000000000CC1
1111111111111111111111111111111111