WE ./imgs/wall1.png


EA ./imgs/wall1.png
NO ./imgs/wall1.png

F 100,200,1
SO ./imgs/wall1.png

C  0,180,255


111111111111111111111111111111111111111111
1N1D00000000000000000000000000000111111111
101001010010000010100100000001010111111111
101001001010101000100100000001011111111111
10000000000000000000000000000000111111111
111111111111111111111011111111111111111111
100000000011111111111011111111111111111111
111111111010000000000011111111111111111111
111111111010111111111111111111111111111111
111111111010111111111110000111111111111111
111111111010000000000000110111111111111111
111111111011111111111111110111111111111111
111111100000000000000000000111111111111111
111111111111111111111111111111111111111111
111111111111111111111111111111111111111111
111111111111111111111111111111111111111111
111111111111111111111111111111111111111111
111111111111111111111111111111111111111111
111111111111111111111111111111111111111101
111111111111111111111111111111111111111111